###############^##############
# #      ######    o    ####!#
# # # #####   # ####    #    #
# #!#         # #§3#### # ####
# ###   B     # ## #    # C  #
# #           # ## #A####### #
# #1  ######  #    #   #   # #
# #####       ######   #   # #
# C             #      ##### #
# ## #    # A   #  A   B     #
# #2 #    #     #      ##### #
# #######C##    #      #   # #
#A#             #      # ### #
# #           # # #      #   #
< #      #    #####    # ### >
# #    ###      #      #   # #
#A#  B #        #      ###3# #
# #    #        A      #2### #
# #    ##############  #     #
# #             #      #######
# ######                 #   #
# #    #       ###       #   #
###### ##      ###    C  #   #
#    o      C  ###     #o#####
# ########     # A     #   #1#
# #13#   ####  # ####  ### #1#
# ## #         # #       #B# #
# ## # A##     #§#       # # #
#    #  ##     #!#       #   #
##############v###############
