##############??##############
# #      ######    o    ####!#
# # #A#####   # ####    #    #
# #!#         # #§3#### #B####
# ###         # ## #    #    #
# #           # ## #A####### #
# #1  ######  #    #   #   # #
# #####       ######   #   # #
# C             #      ##### #
# ## #    #     #      B     #
# #2 #    #     #      ##### #
# ####### ##    #      #   # #
# #             #      # ### #
# #           # # #      #   #
# #      #    #####    # ### #
# #    ###      #      #   # #
# #    #        #      ###3# #
# #CBBC#        B      #2### #
# #    ##############BB#     #
# #             #      #######
# ######        C        #####
# #    #       ###       #####
###### ##      ###       #####
#    o         ###     #o#####
# ########     # A     #   #1#
# #13#   ####  # ####  ### #1#
# ## #         # #       # # #
# ## # A##     #§#       # # #
#    #  ##     #!#       #   #
##############################
Est :
Sud :
Ouest :
Nord : niveau3.level

A
Pv : 5
Force : 1
Armure : 1

B
Pv : 10
Force : 2
Armure : 3

C
Pv : 20
Force : 5
Armure : 5